####################
#.......@..........#
#.#######.#######.#.#
#.#.......#.....#.#.#
#.#.###.#.#.###.#.#.#
#.#.#...#...#.#.#.#.#
#.#.#.###.###.#.#.#.#
#.#.#.#.....#...#.#.#
#.#.#.###.###.#.#.#.#
#.#.#.#.....#.#.#.#.#
#.#.#.#######.#.#.#.#
#.#.#...#...#.#.#.#.#
#.#.###.#.#.###.#.#.#
#.#.....#.#.....#.#.#
#.#######.#######.#.#
#..#............#.#.#
#.#.###########.#.#.#
##......*........#.#
#.#################.#
####################