####################
#@.................#
#.#####.#.#######.#
#.#.....#.#...#...#
#.#.#######.###.###
#.#.......#.#.#.#.#
#.#######.###.#####
#.......#...#...#..#
#.###.#####.#####.#
#.#...#.......#.#..#
#.#.###.#####.###.#
#.#.#...#.#.#.....#
#.#.#####.#.#.###.#
#.#.......#...#...#
#.#######.#####.###
#.#.....#.#.....#.#
#.#.###.#.#######.#
#.#.......#...*#...#
#..#...............#
####################