####################
#@#...#.#.....#.#.#
#.#.#.#.#.###.#.#.#
#.#.#.#.#.#.#.#.#.#
#.#.#.#.#.#.#.#.#.#
#.#.#.#.#.#.#.#.#.#
#.#.#.#.#.#.#.....#
#.#.###.#.#.#####.#
#.#...#.#.#.....#.#
#.#####.#.#.###...#
#.......#.#.#.#.#.#
#.#####.#.#.#.#.#.#
#.#...#.#.#.#.#.#.#
#.#.###.#.###.#.###
#.#.#...#...#...#.#
#.#.#.###.###.###.#
#.#.#.......#.....#
#.#.#####.###.###.#
#.#.........#...#*#
###################
